WSX = "countries/Wessex.txt"
SSX = "countries/Essex.txt"
ESX = "countries/Sussex.txt"
EAG = "countries/East Anglia.txt"
MER = "countries/Mercia.txt"
KNT = "countries/Kent.txt"
LND = "countries/London.txt"
WGR = "countries/West Germany.txt"
DDR = "countries/East Germany.txt"
CRT = "countries/Crete.txt"
NER = "countries/Northern Epirus.txt"
CSV = "countries/Old Castille.txt"
CSM = "countries/Castilla la Mancha.txt"
MDR = "countries/Madrid.txt"
ASY = "countries/Assyria.txt"
DON = "countries/Don Republic.txt"
AKN = "countries/Astrakhan.txt"
AKG = "countries/Arkhangelsk.txt"
IGR = "countries/Ingria.txt"
PEM = "countries/Perm.txt"
FIU = "countries/Fiume.txt"
LZS = "countries/Lazistan.txt"
ZAZ = "countries/Zazaistan.txt"
WAM = "countries/West Armenia.txt"
GOT = "countries/Gotland.txt"
SMA = "countries/Smaland.txt"
MOU = "countries/Mountain Republic.txt"
GRS = "countries/Grisons.txt"
TIC = "countries/Ticino.txt"
VLS = "countries/Valais.txt"
RMD = "countries/Romandie.txt"
VLH = "countries/Volhynia.txt"
PLD = "countries/Podolia.txt"
BDZ = "countries/Budzhak.txt"
ZAP = "countries/Zaporizhzhia.txt"
DNB = "countries/Donbass.txt"
SLB = "countries/Slobozhanshchyna.txt"